a	一(個)
August	八月
black	黑色(的)
camp	露營
aunt	伯(叔)母
blackboard	黑板
can	能夠
autumn	秋天
blanket	毯子
candle	蠟燭
away	遠離
blind	瞎的
candy	糖果
able	能夠…的
baby	嬰兒
block	街區
cap	(無邊便)帽
about	關於
back	背後
blow	吹
car	車子
above	在…上方
bad	壞的
blue	藍色(的)
card	卡片
abroad	在國外
badminton	羽毛球
boat	船
care	關心
across	在…對面
bag	袋子
body	身體
careful	仔細的
actress	女演員
bake	烘烤
boil	煮沸
carry	攜帶
afraid	害怕的
bakery	麵包店
book	書
case	情形
after	在…之後
balcony	陽台
bookstore	書店
castle	城堡
afternoon	下午
ball	球
bored	感到厭煩的
cat	貓
again	再一次
banana	香蕉
boring	無聊的
catch	趕上
age	年齡
band	樂團
born	出生
celebrate	慶祝
ago	以前
bank	銀行
borrow	借入
agree	同意
barbecue	烤肉
boss	老板
cent	(一)分錢
ahead	在前方
baseball	棒球
both	兩者都
center	中心
air	空氣
basket	籃子
bottle	瓶子
centimeter	公分
airplane	飛機
basketball	籃球
bottom	底部
chair	椅子
airport	機場
bat	蝙蝠
bow	敬禮
chalk	粉筆
all	全部
bath	洗澡
bowl	碗
chance	機會
almost	幾乎
bathroom	浴室
box	盒子
change	零錢
along	沿著
be	是
boy	男孩
cheap	便宜的
already	已經
beach	海灘
bread	麵包
cheat	欺騙
also	也
bean	豆
break	打破
check	檢查
always	總是
bear	熊
breakfast	早餐
cheer	歡呼
beautiful	美麗的
bridge	橋
cheese	乳酪
America	美國
because	因為
bright	明亮的
chess	西洋棋
American	美國的
become	變成
bring	帶來
chicken	雞肉
and	和
bed	床
brother	兄弟
child	小孩
angry	生氣的
bedroom	臥室
brown	褐色(的)
China	中國
animal	動物
bee	蜜蜂
brush	刷
Chinese	中文
another	另一個
beef	牛肉
bug	小蟲
chocolate	巧克力
answer	回答
before	在…之前
build	建造
choose	選擇
ant	螞蟻
begin	開始
bun	小圓麵包
chopsticks	筷子
any	任何的
behind	在…後面
burn	燃燒
Christmas	聖誕節
anyone	任何人
believe	相信
bus	公車
church	教堂
anything	任何事物
bell	鈴
business	生意
circle	圓圈
apartment	公寓
belong	屬於
businessman	商人
city	城市
appear	出現
below	在…下方
busy	忙碌的
clap	拍手
apple	蘋果
belt	皮帶
but	但是
class	班級
April	四月
bench	長椅
butter	奶油
classmate	同班同學
arm	手臂
beside	在…旁邊
butterfly	蝴蝶
classroom	教室
around	在…四周
between	在…之間
buy	買
clean	打掃
arrive	到達
bike	腳踏車
by	藉著
clear	清楚的
art	美術
big	大的
cage	籠子
clerk	店員
as	與…一樣
bird	鳥
cake	蛋糕
climb	爬
ask	問
birthday	生日
call	打電話
clock	時鐘
at	在
bite	咬
camera	照相機
close	關上
clothes	衣服
desk	書桌
eleven	十一
fifteen	十五
cloudy	多雲的
dictionary	字典
eleventh	第十一
fifteenth	第十五
club	社團
die	死亡
else	其他的
fifth	第五
coat	大衣
different	不同的
fifty	五十
coffee	咖啡
difficult	困難的
end	結束
fight	打架
Coke	可樂
dig	挖掘
engineer	工程師
fill	裝滿
cold	寒冷的
English	英語
finally	最後
collect	收集
dinner	晚餐
enjoy	喜愛
find	找到
color	色彩
dirty	骯髒的
enough	足夠的
fine	很好的
come	來
dish	盤子
enter	進入
finger	手指
comb	梳子
do	做
envelope	信封
finish	完成
comfortable	舒適的
doctor	醫生
eraser	橡皮擦
fire	火
comic	連環畫的
even	前夕
first	第一
common	共同的
dog	狗
even	甚至
fish	魚
computer	電腦
doll	洋娃娃
evening	傍晚
fisherman	漁夫
convenient	方便的
dollar	元
ever	曾經
five	五
cook	煮飯
door	門
every	每一個
fix	修理
cookie	餅乾
dot	點
everyone	每一個人
floor	地板
cool	涼爽的
down	向下
everything	每件事
flower	花朵
copy	抄寫
dozen	一打
example	例子
flute	笛
corner	角落
dragon	龍
excellent	極好的
fly	飛
correct	正確的
draw	畫
except	除了…之外
follow	遵循
cost	價值
drawer	抽屜
excited	感興奮的
food	食物
couch	沙發
dream	做夢
exciting	令人興奮的
foot	腳
count	數
dress	洋裝
excuse	原諒
for	為了
country	鄉村
drink	喝
exercise	運動
foreign	外國的
course	課程
drive	駕駛
expensive	昂貴的
foreigner	外國人
cousin	(表)兄弟姊妹
driver	駕駛者
experience	經驗
forget	忘記
cover	覆蓋
drop	掉落
eye	眼睛
fork	叉子
cow	母牛
drum	鼓
face	臉孔
forty	四十
cowboy	牛仔
dry	乾的
fact	事實
four	四
crazy	瘋狂的
duck	鴨
factory	工廠
fourteen	十四
cross	越過
dumpling	湯圓
fail	失敗
fourteenth	第十四
cry	哭
during	在…期間
fall	秋天
fourth	第四
cup	茶杯
each	每一
family	家庭
fox	狐狸
cut	切
ear	耳朵
famous	有名的
free	空閒的
cute	可愛的
early	早的
fan	迷
dance	跳舞
earth	地球
far	遠的
fresh	新鮮的
dangerous	危險的
east	東方
farm	農田
Friday	星期五
dark	黑暗的
Easter	復活節
farmer	農夫
friend	朋友
date	日期
easy	容易的
fast	快的
friendly	友善的
daughter	女兒
eat	吃
fat	胖的
frisbee	飛盤
day	日子
egg	蛋
father	父親
frog	蛙
dead	死的
eight	八
favorite	最喜愛的
from	從
dear	親愛的
eighteen	十八
February	二月
front	前面
December	十二月
eighth	第八
feed	餵
fruit	水果
decide	決定
eighty	八十
feel	覺得
fry	油炸
delicious	美味的
either	也不
festival	節慶
full	滿的
dentist	牙醫
fever	發燒
fun	樂趣
elephant	大象
few	少數的
funny	好笑的
future	未來
hard	困難的
hurry	趕忙
knowledge	知識
game	比賽
hurt	受傷
koala	無尾熊
garbage	垃圾
hat	帽子
husband	丈夫
lake	湖
garden	花園
hate	討厭
I	我
lamp	燈
gas	瓦斯
have	有
ice	冰
land	土地
gate	大門
he	他
language	語言
get	得到
head	頭
idea	主意
lantern	燈籠
ghost	鬼
headache	頭痛
if	如果
large	大的
giant	巨大的/巨人
health	健康
important	重要的
last	最後的
gift	禮物
healthy	健康的
in	在…裡面
late	晚的
girl	女孩
hear	聽
insect	昆蟲
later	較晚
give	給予
heart	心
laugh	笑
glad	高興的
heat	熱
interest	使感興趣
lawyer	律師
glass	玻璃杯
heavy	重的
interested	感興趣的
lazy	懶惰的
glasses	眼鏡
hello	喂
interesting	有趣的
lead	引導
glove	手套
help	幫忙
interview	訪問
leader	領導者
glue	膠水
helpful	有幫助的
Internet	網路
learn	學習
go	去
hen	母雞
into	到…之內
least	最少
goat	山羊
here	這裡
invite	邀請
leave	離開
good	好的
hey	嘿
island	島嶼
left	左邊
goodbye	再見
hi	嗨
it	它
leg	腿
goose	鵝
hide	隱藏
jacket	夾克
lemon	檸檬
grade	成績
high	高的
January	一月
lend	借出
gram	公克
hike	徒步旅行
jeans	牛仔褲
less	較少的
grandfather	祖父
hill	小山
job	工作
lesson	課
grandmother	祖母
hippo	河馬
jog	慢跑
let	讓
grape	葡萄
history	歷史
join	加入
letter	信
grass	草
hit	打擊
joy	歡樂
lettuce	萵苣
gray	灰色的
hobby	嗜好
juice	果汁
library	圖書館
great	很棒的
hold	拿著
July	七月
lid	蓋子
green	綠色(的)
holiday	假日
jump	跳躍
lie	說謊
ground	地面
home	家
June	六月
life	生活
group	團體
homework	家庭作業
light	燈
grow	種植
honest	誠實的
just	只是
like	喜歡
guava	番石榴
honey	蜂蜜
kangaroo	袋鼠
line	隊伍
guess	猜想
hop	(單腳)跳
keep	保持
lion	獅子
guitar	吉他
hope	希望
key	鑰匙
lip	嘴唇
guy	傢伙
horse	馬
kick	踢
list	表
gym	體育館
hospital	醫院
kid	小孩
listen	聽
habit	習慣
hot	熱的
kill	殺
little	小的
hair	頭髮
kilo	公斤
live	住
half	一半
hotel	旅社
kind	種類
Halloween	萬聖節
hour	小時
king	國王
lonely	寂寞的
ham	火腿
house	房屋
kiss	吻
long	長的
hamburger	漢堡
housewife	家庭主婦
kitchen	廚房
look	看
hand	手
how	如何
kite	風箏
lose	遺失
handsome	英俊的
however	然而
knee	膝蓋
loud	大聲的
hang	懸掛
hundred	百
knife	刀子
love	喜愛
happen	發生
hungry	飢餓的
knock	敲
lovely	可愛的
happy	快樂的
hunt	打獵
know	知道
low	低的
lucky	幸運的
mother	母親
nurse	護士
photo	相片
lunch	午餐
motorcycle	機車
piano	鋼琴
machine	機器
mountain	山
October	十月
pick	撿拾
mad	瘋狂的
mouse	老鼠
picnic	野餐
magic	神奇的
mouth	嘴巴
off	自…離開
picture	圖片
mail	信件
move	移動
office	辦公室
pie	派
mailman	郵差
movie	電影
officer	警官
piece	片
make	製作
often	時常
pig	豬
man	男人
oil	油
pin	大頭針
many	許多的
MRT	捷運
OK	可以
pink	粉紅色(的)
map	地圖
old	老的
pipe	管
March	三月
much	許多的
on	在…上面
pizza	披薩
mark	做記號
mud	泥
once	一次
place	地方
marker	簽字筆
museum	博物館
one	一
plan	計畫
market	市場
music	音樂
only	只
planet	行星
married	已婚的
must	必須
open	打開
plant	植物
mask	面具
nail	釘子
or	或
plate	盤子
mat	墊子
name	名字
orange	柳橙
play	玩
math	數學
national	國家的
order	點餐
player	選手
matter	事情
near	在…附近
other	其他的
playground	操場
may	可能
neck	脖子
out	在外
pleasure	樂事
May	五月
need	需要
please	請
maybe	也許
neighbor	鄰居
over	結束
meal	一餐
never	從不
own	自己的
pocket	口袋
mean	意指
new	新的
ox	公牛
point	指著
meat	肉
news	消息
pack	包
police	警察(方)
medicine	藥
next	下一個
package	包裹
polite	有禮貌的
medium	中號
nice	好的
page	頁
pond	池塘
meet	遇見
night	晚上
paint	繪畫
pool	游泳池
meeting	會議
nine	九
pair	一雙
poor	貧困的
menu	菜單
nineteen	十九
pants	長褲
popcorn	爆米花
mile	哩
nineteenth	第十九
papaya	木瓜
popular	受歡迎的
milk	牛奶
ninety	九十
paper	紙
pork	豬肉
million	百萬
ninth	第九
parent	父(母)親
possible	可能的
mind	介意
no	沒有
park	公園
minute	分鐘
nobody	無一人
part	部分
postcard	明信片
Miss	小姐
nod	點頭
party	派對
pot	罐
miss	想念
noise	噪音
pass	通過
pound	磅
mistake	錯誤
noodle	麵條
past	經過
practice	練習
modern	現代化的
noon	中午
paste	黏貼
pray	祈禱
moment	片刻
north	北方
pay	付錢
prepare	準備
Monday	星期一
nose	鼻子
PE	體育
present	禮物
money	錢
not	不
peach	桃子
pretty	漂亮的
monkey	猴子
note	筆記
pear	梨子
price	價格
month	月份
notebook	筆記本
pen	筆
princess	公主
moon	月亮
nothing	沒什麼
pencil	鉛筆
prize	獎
mop	拖地
notice	注意到
people	人們
problem	問題
more	更多的
November	十一月
perhaps	或許
program	節目
morning	早上
now	現在
person	人
proud	驕傲的
most	大多數的
number	號碼
pet	寵物
public	公立的
pull	拉
row	划(船)
ship	船
sofa	沙發
pumpkin	南瓜
rule	規則
shirt	襯衫
soldier	軍人
purple	紫色的
ruler	尺
shoe	鞋子
some	一些
push	推
run	跑
shop	商店
someone	某人
put	放
sad	悲傷的
shopkeeper	店主
something	某事
quarter	一刻鐘
safe	安全的
short	短的
sometimes	有時候
queen	皇后
sail	航行
shorts	短褲
somewhere	某處
question	問題
salad	沙拉
should	應該
son	兒子
quick	迅速的
sale	出售
shoulder	肩膀
song	歌曲
quiet	安靜的
salesman	推銷員
shout	喊叫
soon	不久
quite	相當
salt	鹽
show	指示
sore	疼痛的
quiz	小考
same	相同的
shy	害羞的
sorry	抱歉
rabbit	兔子
sandwich	三明治
sick	生病的
sound	聽起來
race	賽跑
Saturday	星期六
side	旁邊
soup	湯
radio	收音機
sacred	神聖的
sidewalk	人行道
south	南方
railroad	鐵路
save	節省
sight	視力
space	空間
rain	下雨
say	說
sign	標誌
spaghetti	義大利麵
rainbow	彩虹
school	學校
simple	簡單的
speak	說
rainy	下雨的
science	科學
since	自從
special	特別的
raise	舉起
scooter	速克達機車
sing	唱歌
spell	拼字
rat	老鼠
screen	螢幕
singer	歌手
spend	花費
read	讀
sea	海
sir	先生
spider	蜘蛛
ready	準備好的
season	季節
sister	姊妹
spoon	湯匙
real	真的
seat	座位
sit	坐
sport	運動
really	真地
second	第二
six	六
spring	春天
recorder	錄音機
secretary	秘書
sixteen	十六
square	正方形的
red	紅色(的)
see	看
sixteenth	第十六
stairs	樓梯
refrigerator	冰箱
seed	種子
sixth	第六
stamp	郵票
remember	記得
seesaw	蹺蹺板
sixty	六十
stand	站立
repeat	重複
seldom	很少
size	尺寸
star	星星
reporter	記者
sell	賣
skate	溜冰
start	開始
rest	休息
send	寄
skirt	裙子
station	車站
restaurant	餐館
sky	天空
stay	停留
restroom	洗手間
sentence	句子
sleep	睡覺
steak	牛排
rice	米飯
September	九月
slide	溜滑梯
still	仍然
rich	有錢的
serious	嚴重的
slim	苗條的
stomach	胃
ride	騎
set	(電視)機
slow	慢的
stop	停
right	右方
seven	七
small	小的
store	商店
ring	戒指
seventeen	十七
smart	聰明的
straight	直的
river	河
seventeenth	第十七
smell	聞起來
story	故事
road	道路
seventh	第七
smile	微笑
strange	奇怪的
robot	機器人
seventy	七十
smoke	煙
stranger	陌生人
ROC	中華民國
several	幾個的
snack	點心
strawberry	草莓
rock	岩石
shake	搖動
snake	蛇
street	街道
roll	滾
shall	將
snow	下雪
strong	強壯的
room	房間
shape	形狀
snowman	雪人
student	學生
share	分享
snowy	下雪的
study	研讀
rope	繩子
shark	鯊魚
so	如此地
stupid	笨的
rose	玫瑰
she	她
soccer	足球
subject	科目
round	圓形的
sheep	綿羊
socks	襪子
successful	成功的
sugar	糖
third	第三
turn	轉動
week	星期
summer	夏天
thirsty	口渴的
turtle	烏龜
weekend	週末
sun	太陽
thirteen	十三
twelfth	第十二
welcome	受歡迎的
Sunday	星期日
thirteenth	第十三
twelve	十二
well	好地
sunny	晴朗的
thirty	三十
twenty	二十
west	西方
supermarket	超市
this	這個
twentieth	第二十
wet	濕的
sure	確定的
throat	喉嚨
twice	兩次
whale	鯨魚
surf	衝浪
throw	丟
two	二
what	什麼
surprise	使驚訝
those	那些
type	打字
when	何時
surprised	感驚訝的
though	雖然
typhoon	颱風
where	何處
sweater	毛衣
thousand	千
umbrella	雨傘
whether	是否
sweet	甜的
three	三
uncle	伯(叔)
which	哪一個
swim	游泳
Thursday	星期四
under	在…之下
white	白色(的)
swing	鞦韆
ticket	票
understand	了解
who	誰
table	桌子
tidy	整潔的
unhappy	不快樂的
whose	誰的
tail	尾巴
tiger	老虎
uniform	制服
why	為什麼
Taiwan	臺灣
tie	領帶
until	直到
wife	妻子
take	拿
time	時間
up	向上
will	將
talk	說話
tired	疲倦的
USA	美國
win	贏
tall	高的
to	到
use	使用
wind	風
tape	錄音帶
toast	土司
useful	有用的
window	窗戶
taste	品嚐
today	今天
usually	通常
windy	多風的
taxi	計程車
toe	腳趾
vacation	假期
winter	冬天
tea	茶
together	一起
vegetable	蔬菜
wise	明智的
teach	教
tomato	番茄
very	非常
wish	希望
teacher	教師
tomorrow	明天
vest	背心
with	和
team	團隊
tonight	今晚
video	影像的
without	沒有
teenager	青少年
too	也
violin	小提琴
woman	女人
telephone	電話
tooth	牙齒
visit	參觀
wonderful	極好的
television	電視
top	頂端
voice	聲音
word	字
tell	告訴
total	總計
wait	等待
work	工作
temple	寺廟
touch	碰觸
waiter	男服務生
workbook	作業本
ten	十
towel	毛巾
waitress	女服務生
worker	工人
tennis	網球
town	城鎮
wake	醒來
world	世界
tenth	第十的
toy	玩具
walk	走路
worry	擔心
terrible	可怕的
traffic	交通
wall	牆壁
write	寫
test	考試
train	火車
wallet	皮夾
writer	作家
than	比…
trash	垃圾
want	想要
wrong	錯誤的
thank	謝謝
treat	請客
warm	溫暖的
yard	庭院
that	那個
tree	樹
wash	清洗
year	年
the	這/那
trick	惡作劇
watch	看
yellow	黃色(的)
theater	戲院
trip	旅行
water	水
yes	是
then	那時
trouble	麻煩
watermelon	西瓜
yesterday	昨天
there	那裡
truck	卡車
wave	波浪
yet	尚未
these	這些
true	真實的
way	道路
you	你(們)
they	他們
try	嘗試
we	我們
young	年輕的
thick	厚的
weak	弱的
yummy	好吃的
thin	瘦的
tub	浴缸
wear	穿
zebra	斑馬
thing	事情
Tuesday	星期二
weather	天氣
zero	零
think	想
turkey	火雞
Wednesday	星期三
zoo	動物園